NO images/512.xpm
SO images/ciel.xpm
WE images/miroirs_roses.xpm
EA images/miroirs_violet.xpm

F 201,100,89
C 145,130,254

1111  1111 111
1001111001110111
1000000000000001
1111111000000101
      1111000101
      1000000001
1111111000001111
10000000E0001
1111111111111

armand

lol

ok

test




ok